R 1000 540
NO ./textures/stone.xpm
SO ./textures/mossy.xpm
WE ./textures/redbrick.xpm
EA ./textures/wood.xpm
S ./sprites/barrel.xpm
C 156,248,237
F 202,139,63


11111111111111 1111111111
1N00000000000111000000001
1011000001110000000002001
100100000000000000000000111111111
111111111011000001110000000000001
100000000011000001110111111111111
11110111111111011100000010001
11110111111111011101010010201
11000000110101011100000000001
10002000000000001100000010001
10000000000000001101010010001
11000001110101011101011110001
11110111111101011101111000001
11111111111111111111111111111
