R 2000 1000
NO ./textures/stone.xpm
SO ./textures/mossy.xpm
WE ./textures/redbrick.xpm
EA ./textures/wood.xpm
S ./sprites/barrel.xpm
C 156,248,237
F 202,139,63


                1111111111      1111111111     1111111111111111111111111111
 1111111111     1111111111      1111111111     1111111111111111111111111111
 1000000001     1100000001      1000000001     1000000000000000000000000001
11000002001     1100000001      1000000001     10000000001111111110000000011
110N0000001     1000000011      1000000001     100000000011      10000000011
11001000011     1100000001      1000000001     100000000011      10000000011
11000000011     1100000001      1000000001     100000000011      10000000011
11000000211     1100000001      1000000001     100000000011      10000000011
11000000011     1100000001      1000000001     10000000000111111110000000011
1100000001111111110000000111111110000000011111110000000000000000000000000011
1100000000000000000000000000000000000000000000000000000000000000000000000011
1100000001111111100000001111111110000000011111110000000001111111111111111111
11000000001111111100000001      1000000001     10000000001
11000000001     1100000001      1000000011     10000000001
10000000001     1100000001      1000000011     10000000001
10000000001     1100000001      1000000011     10000000001
10000000001     1100000001      1000000011     10000000001
11000000001     1100000001      1000000011     10000000001
11000000001     1100000001      1000000011     10000000001
10000000001     1110000001      1000000001     10000000001
100000000111111 1111111111      1111111111     11111111111
1100000000000011
100000000111111 1111111111       1111111111111111111111111     1111111111111111111111111111111
10000000011     1000000001       1000000000000000000000001     1110000000000000000000000000011
10000000011     1000000001       1000000000000000000000001     1100000001000000000000000000001
10000000011     1000000001       1000000000000000000000001     1100000000000000000000000000001
11000000011     1000000011       1000000001111111100000001     1100000000111111111111000000001
11000000011     1000000001       1000000011     1100000001     11000000011          1111001111
11000000011     1000011111       1000000011     1100000001     11000000011          1111000001
11000000011     100001           1000000011     1100000001     11000000011          1000000001
11000000011     1000011111       1000000011111111100000001     1100000000111111111111000000111
1100000001111111110000000111111111000000000000000000000001111111100000001000000000000000000001
1100000000000000000000000000000000000000000000000000000000000000000000000000000000000000000001
1100000000000000000000001111111111000000000000000110000001111111000000000000000000000000000011
11000000001111111100000001       1100000001111111100000001     100000000001111110111111110111
11000000011     1100000011       1100000001     1100000001     100000000011    1111    1111
11000000011     1100000011       1100000001     1100000001     10000000001
11000000011     1100000011       1100000001111111000000001     10000000001
11000000011     1100000011       1100000000000000000000001     10000000001
11000000011     1100000011       1100000000000000000000001     10000000001
11000000011     1100000011       1000000000000000000000001     10000000001
11111111111     1111111111       1011111111111111111111111     11111111111
11111111111     1111111111       1011111111111111111111111     111111111
                                 101
111111111111111111111111111111111101111111111111111111111111
100000000000000000000000000000000000000000000000000000000001    111111111111
1111111111111111111111111111111111111111111111111111111110011111100000000001
                                                        10000000000111111111
                                                        110111111111
                                                         1111