R 500 300  
NO brick.xpm
SO dirt.xpm
EA stone.xpm
WE wood.xpm
S brice_sprite.xpm
C 106,176,76
F 83,92,104
11111111
10011001
10000001
10000001
10000001
10000001
10000001
10000001
10000001
10000001
10000001
1000N001
10000001
10000001
11111111