R 700 400  
NO brick.xpm
SO dirt.xpm
EA stone.xpm
WE wood.xpm
S brice_sprite.xpm
C 106,176,76
F 83,92,104
1111111111111111111111111
1000000000110000000000001
101100000111000200S000001
100100000000000000000000111111111
111111111011000001110000000000001
100000011111111110111011111111111
11110111        1000000100001
1111011  11111111000010010201
11000011110101000000000000001
10002000000000001100000010001
10000000000000001101010010001
11000001110101011101011110001
11110111111101011101111000001
11111111111111111111111111101
                          101
11111111111111111111111111101
10000000000000000000000000001
11111111111111111111111111111