R 700 400  
NO brick.xpm
SO dirt.xpm
EA stone.xpm
WE wood.xpm
S brice_sprite.xpm
C 106,176,76
F 83,92,104
11111111
10011001
10000001
10000001
10000001
10000001
10000001
10000001
10000001
10000001
10000001
10000001
10000001
10000001
10000001
10000001
10000001
1000000
10000001
10000001
10000001
10000001
10000001
10000001
10000001
10000001
10000001
10000001
10000001
10000E01
10000001
10000001
11111111