R 500 300  
NO brick.xpm
SO dirt.xpm
EA stone.xpm
WE wood.xpm
S brice_sprite.xpm
C 106,176,76
F 83,92,104
11111  111111111111111111
1001011000110W0001010000111111111
10101000011100000001000000000001
1001000000001111100000000000001
1111111110111   10011100000001
1000000000110111000000011111111
11110111111111011100000010001001
111101111111110111010100102011111
1100000011010101110000000000000011
10002000000000001100000010001101
1000000000000000110101001000111
11000001110101011101011110001
11110111111101011101111000001
11111111111111111111111111111