R 500 300  
NO brick.xpm
SO dirt.xpm
EA stone.xpm
WE wood.xpm
S brice_sprite.xpm
C 106,176,76
F 83,92,104
1111111111111
1000000000001
1000000000001
100000000101111
1000000001
1000000001
1000N00001
1000000001
1000000001
1111011111