R 1920 1080

NO ./path_to_the_south_texture
SO ./path_to_the_south_texture
WE ./path_to_the_west_texture
EA ./path_to_the_east_texture
S  ./path_to_the_sprite_texture

F 220,100,230
C 225,30,0

1111   11111
11111111011111
100000000000011
10000000011111
100000N001
1111111111