R 1200 1000

444444444444444422222222
400000000000000020000002
401000000000000000000002
402000000000000000000002
403000000000000020000002
404000044444444422022222
404000040404040420002221
401000040000000420000004
402000000000000000002221
404000040000000420000000
400000040000000420002221
400000044440444422222221
111111111110111111111111
400000000000000000000W01
111111011110111111111111
444444044410122222223333
400000000410120000020002
400000000000120040020002
400000000410120000022022
401010000410000040000002
400400000410120000022022
401010000410120040020002
400000000410120000020002
444444444411122222233333