R 1640 980

44444444444444444411
30000000000000010001
30102030400000020101
30000000000000030101
30000000000000040101
30000000000000040101
30000000000001110101
3E000000000000000101
11111111111111111101
44444444444444444401
30000000000000000101
30000000000004420101
30000000000000030101
30000000000000040101
30000000000000040101
30000000000000010101
30000000000000010001
11111111111111111111