R 1920 1080

NO ./path_to_the_south_texture
SO ./path_to_the_south_texture
WE ./path_to_the_west_texture
EA ./path_to_the_east_texture
S  ./path_to_the_sprite_texture

F 220,100,0
C 225,30,0

        11111111111     11111111111111
        11000000001       100000001111
        101100001111111111102000000001
        10010001    100000000000111111
111111111011001111   100000000001
100000000011000001111100001111111
11110111111111011100000010001
11000000110101011100000010001
1000200000000000110000001000111
100000000W0000001101010010001
1100000111010101111101111000111
11110111 1110101 101111010001
11111111 1111111 111111111111
1 1111111111111111 11111111111
111111111111      111111111111111111
1111111111111111111     111
111111