R 1920 1080

11111111111111111111111111111
11110111111111011100000010001
11000000110101011100000010001
10002000000000001100000010001
100000N0000000000001010010001
11000001110101011111011110001
11110111111101011101111010001
11111111111111111111111111111