
R 1920 1080

SO ./path_to_the_south_texture
WE ./path_to_the_west_texture
NO brick.xpm
EA ./path_to_the_east_texture
S  ./path_to_the_sprite_texture

F 220,100,0
C 225,30,0

11111111111111111111111111111
11110111111111011100000010001
11000000110101011100000010001
10002000000000001100000010001
100000000000000011010100100N1
11000001110101011111011110001
11110111 1110101 101111010001
11111111 1111111 111111111111